help	<function>	Get help for a function.
%	<code>	Admin shell, loadstrings code.
dns	<host>|<ip> [verbose]	DNS resolve host into an IP or vice versa.
list		List available commands.
ping		Check if bot is up.
remind	<time> `<event>`	Remimd about an event in given amount of seconds.
echo	<text>	Echoes text.
reboot		Restarts the bot reloading all code and resetting environment.
load	<file>	Dynamically load a file.
insmod	<module>	Dynamically register module.
rmmod	<module>	Dynamically unregister module.
upmod	<module>	Update registered module.
calc	<expression>	Calculate a math expression
lsmods		List all loaded modules
isup	<host> [port]	Check if remote host is up
lua	<code>	Execute lua code in a sandbox
base	<from> <to> <number>	Convert a number from one base to another. If base is larger than 36, digits are expressed as groups in parenthesis.
false	<expression>	Evaluate an expression of FALSE programming language.
me		How? I'm just a lua bot...
geoip	<ip>|<host>|<nickname>|<nickname>@<network>	Get approximate location of an ip or a user. Notice that street-level address usually points to the ISP.
